11111111111111111111111111111111111111111111111111
1000E0000000000C00000C00000000C0000000100000000101
11111111001000001010010000000101000000111011111101
10100100101010100010010000000101111110001000000001
1P0000000C00C00000000000000000010000000000000001C1
11111111111111111111111111111111111111111111111111