11111111111111111111111111111111111111111
10000000000000C0000000000000000000000C001
10000000000000000000000000000000000000001
100EP000000000111111100111111111111111001
10000000000000111111100111111111111111001
10000000000111111110000111110011111111001
10000000000111111110000111100011111111001
100000000111111100000001100C0011111111001
10000000011111110000000100000011111111001
10000011111111C00000000000000011111110001
1000001111111100000000000000001111111C001
10001111111C00000000000000011111111000001
10001111111000000000000000011111111000001
100111111C0000000000000001111111000000001
10011111100000000000000001111111000000001
100111100000000C0000000111111100000000001
10011110000000000000C00111111100000000001
10011111111111111111100111111100000111001
10011111111111111111100111111100000111001
10011111111111111111100111111100011111001
10011111111111111111100111111100011111001
10000000000000111111100111111101111111001
10000000000000111111100111111101111111001
10000CCCC00000111111100000000000000000001
10000CCCC00000111111100000000000000000001
10000000000000111111100000000000000000001
10000000000000000000000000000C00000000001
11111111111111111111111111111111111111111